NO ./Textures/wood0.xpm
SO ./Textures/wood0.xpm
EA ./Textures/wood0.xpm
WE ./Textures/wood0.xpm

F 220,100,0
C 225,30,0

111111111111111111111111
1000000000010000010000001
10000000000111011 1100001
1000000000000011010000001
1000000000001000000000001
1000000101010000000000111
1000000010001000000000001
1000000000000000000000001
1000000000N00000000000001
1000000000000000000000001
1111111111111111111111111